NO ./texture/stonewall_texture.xpm
SO ./texture/stonewall_texture.xpm
WE ./texture/stonewall_texture.xpm
EA ./texture/stonewall_texture.xpm

F 220,100,0
C 225,30,0

111111111111111111111111
100000000000000000000001
100000000000000000000001
100000000000000000000001
100001111100001010100001
100001000100000000000001
100001000100001000100001
100001000100000000000001
100001111100001010100001
100000000000000000000001
100000000000000000000001
100000000000000000000001
100000000000000000000001
100000000000000000000001
100000000000000000000001
100000000000000000000001
111111111100000000000001
110000000100000000000001
110111100100000000000001
110100000100000000000001
110111111100000000000001
110000000000000000000001
111111111000N00000000001
111111111111111111111111