NO ./textures/NO.xpm42
SO ./textures/SO.xpm42
WE ./textures/WE.xpm42
EA ./textures/EA.xpm42

F 50,50,40
C 0,0,255

111111111111111
100000000010001
110000001000001
100000111000001
1000000000S0001
111111111111111
