NO ./texture/stonewall_texture.xpm
SO ./texture/stonewall_texture.xpm
WE ./texture/stonewall_texture.xpm
EA ./texture/stonewall_texture.xpm

F 220,100,0
C 225,30,0

111111111111111
100000000010001
110000001000001
100000111000001
1000000000N0001
111111111111111
