C 125,155,200
EA ./textures/EA.xpm42



NO ./textures/NO.xpm42
   WE ./textures/WE.xpm42
        SO ./textures/SO.xpm42

F 60,255,100


        1111111111111111111111111
        1000000000110000000000001
        1011000001110000000000001
        1001000000000000000000001
111111111011000001110000000000001
100000000011000001110111111111111
11110111111111011100000010001
11111111111111011101010010001
11000000110101011100000010001
10000000000000001100000010001
100000000N00000110101001000111
1100000111010101111101111000001
11110111 1110101 10111101000111
11111111 1111111 111111111111