NO ./textures/NO.xpm42
SO ./textures/SO.xpm42
WE ./textures/WE.xpm42
EA ./textures/EA.xpm42

F 60,255,100
C 125,155,200

111111111111111111111111111
100000000000000000000000001
100000000000000000000000001
100000000000000000000000001
100000000000000000000000001
1000000000000000000000000011111111111
1000000000000000000000000000000000001
1000000000000000N00000000011111111101
1000000000000000000000000011111111101
1000000000000000000000000000000000001
1111111111111111111111111111111111111